1111111111111
1001001000C01
1000011111011
1P0011E000001
1111111111111